#######
#.....#
#..##.#
#....E#
#######
